normal
1111111111.....1.
111111111111.....
1.......11111...1
1.......111111...
........11111111.
..111111111111111
..11.......111111
L..1......1111111
1........11..1111
111.1...1.....111
111.1.......11111
111L...1...111111
1111......1111111
1111111...1111111
1.11111D..1111111
11111111..1111111
11111111..1111111
X
mod-strt
1111111111.....1.
111111111111.....
1.......11111...1
1.......111111...
........11111111.
..111111111111111
..11.......111111
L..1......1111111
1........11..1111
111.1...1.....111
111.1.......11111
111L...1...111111
1111......1111111
1111111...1111111
1.11111D..1111111
11111111..1111111
X
mod-key1
1111111111.....1.
111111111111.....
1.......11111...1
1.......111111...
........11111111.
..111111111111111
..11.......111111
L..1......1111111
1........11..1111
111.1...1.....111
111.1.......11111
111L...1...111111
1111......1111111
1111111...1111111
1.11111D..1111111
11111111..1111111
X
mod-key2
1111111111.....1.
111111111111.....
1.......11111...1
1.......111111...
........11111111.
..111111111111111
..11.......111111
L..1......1111111
1........11..1111
111.1...1.....111
111.1.......11111
111L...1...111111
1111......1111111
1111111...1111111
1.11111D..1111111
11111111..1111111
X
mod-end.
1111111111.....1.
111111111111.....
1.......11111...1
1.......111111...
........11111111.
..111111111111111
..11.......111111
L..1......1111111
1........11..1111
111.1...1.....111
111.1.......11111
111L...1...111111
1111......1111111
1111111...1111111
1.11111D..1111111
11111111..1111111
X