normal
11111111111111111
11111111111111111
11111111111111111
11111111111111111
11111111111111111
11111111111111111
11111111111111111
00000000000000000
00L00001100000R00
11110000000111111
11110100001111111
11111111111111111
11.11111111..1111
11.111111111...11
111111111111.1111
11111111111111111
11111111111111111
X
mod-strt
111111111111
000000000000
L0000110000R
110000000111
110100001111
111111111111
X
mod-key1
111111111111
000000000000
L0000110000R
110000000111
110100001111
111111111111
X
mod-key2
111111111111
000000000000
L0000110000R
110000000111
110100001111
111111111111
X
mod-end.
111111111111
000000000000
L0000110000R
110000000111
110100001111
111111111111
X