normal
1 1 1 1 1 1 1 1 1 1 1 1 1 1 1 1 1
1 1 . . . 1 1 1 1 1 . 1 1 1 1 1 1
1 . . 1 1 1 1 1 1 1 1 1 1 1 1 1 1
1 1 1 1 1 1 1 1 1 1 1 1 1 1 1 1 1
1 1 1 . . . . 1 1 . . . 1 1 1 1 1
1 1 . . . 1 . . . . . . . . . S 1
1 1 1 1 . . . . 1 . . . . 1 1 1 1
1 . . . . . . . . . 1 . . . 1 1 1
. . . . 1 1 1 . . 1 1 . . . 1 1 1
. L . 1 1 1 . . . . 1 . 1 1 1 1 1
1 1 . . 1 . . . 1 . . . 1 1 1 1 1
1 . . . 1 1 . 1 1 1 1 . 1 1 1 1 1
1 1 1 1 1 1 1 1 1 1 1 1 1 1 1 1 1
1 1 1 1 1 1 1 1 1 1 1 1 1 1 1 . .
1 1 1 1 1 1 1 1 1 1 . 1 1 1 . . .
1 1 1 . . 1 1 1 1 1 1 1 1 . . . .
1 1 1 1 1 1 1 1 1 1 1 1 1 1 . . .
X
_strt
1 1 1 1 1 1 1 1 1 1 1 1 1 1 1 1 1
1 1 1 1 1 1 0 1 1 1 1 1 1 1 1 1 1
1 1 1 1 1 1 1 1 1 1 0 1 1 1 1 1 1
1 1 1 1 1 1 1 1 1 1 1 1 1 1 1 1 1
1 1 1 1 1 1 1 1 1 1 1 1 1 1 1 1 1
1 1 1 0 0 0 0 1 1 0 0 0 1 1 1 1 1
1 1 0 0 0 1 0 0 0 0 0 0 0 0 0 S 1
1 1 1 1 0 0 0 0 1 0 0 0 0 1 1 1 1
1 0 0 0 0 0 0 0 0 0 1 0 0 0 1 1 1
0 0 0 0 1 1 1 0 0 1 1 0 0 0 1 1 1
0 L 0 1 1 1 0 0 0 0 1 0 1 1 1 1 1
1 1 0 0 1 0 0 0 1 0 0 0 1 1 1 1 1
1 0 0 0 1 1 0 1 1 1 1 0 1 1 1 1 1
1 1 1 1 1 1 1 1 1 1 1 1 1 1 1 1 1
1 1 1 1 1 1 1 1 1 1 1 1 1 1 1 1 1
1 1 1 1 1 1 1 1 1 1 0 1 1 1 1 1 1
1 1 1 1 1 1 1 1 1 1 1 1 1 1 1 1 1
1 1 1 1 1 1 1 1 1 1 0 1 1 1 1 1 1
1 1 1 1 1 1 0 1 1 1 1 1 1 1 1 1 1
X 19y 17x
_key1
22222222222
22222222222
22222222222
22222222222
22222222222
L2222222222
22222222222
22222222222
22222222222
22222222222
X
_key2
22222222222
22222222222
22222222222
22222222222
L2222222222
22222222222
22222222222
22222222222
22222222222
22222222222
X
_end.
22222222222
22222222222
22222222222
22222222222
L2222222222
22222222222
22222222222
22222222222
22222222222
22222222222
X