normal
1111111U.11111111
1111.....13311111
111111..2...11111
111111..1.2111111
1111.........1111
..L......1...R...
..1...2....1111..
1111..211.3311111
111111.2..1311111
1111......111..11
11111...22..11111
111111....2111111
1111.....11..1111
111.........11111
1111..2....111111
11.11.211...11.11
...11111111111.11
X
mod-strt
..11111U.111111..
..11.....133111..
..1111..22..111..
..1111....11111..
..11.........11..
..L.........R11..
..1...2....1111..
..11..211...111..
..1111.2....111..
......11...1.....
......11...1.....
......11...1.....
......11...1.....
......11...1.....
......11...1.....
......11...1.....
......11...1.....
X
mod-key1
11111U01111
11000001331
11110022001
11110000111
11000000000
L000000000R
10002000011
11002110001
11110200001
11111111111
X
mod-key2
11111U01111
11000001331
11110022001
11110000111
11000000000
L000000000R
10002000011
11002110001
11110200001
11111111111
X
mod-end.
11111111U0111111
1111100100001111
1111002210000111
1111000010000111
1100220002110001
0001021010200001
L000011000000000
111000111000000R
1111000000011111
1111111111111111
X