normal
1100U111111
10000201111
10001120011
11000020001
10000011041
10000000011
11100010011
11110000001
10000001041
11000001111
00000011111
L0000011111
11100001111
11100001111
11110000411
11000011111
11110D11111
X
mod-strt
1111100U111111111
11110000201111111
11110001120011.11
11111000020001.11
11110000011021111
111100000000111.1
1111110001001...1
1111111000000...1
11110000001021.11
11111000001111.11
000000000111....1
000L00000111..111
1111110000111..11
11111100001....11
11111110000211111
11111000011111111
11111110D11111111
X
mod-key1
1100U111111
10000201111
10001120011
11000020001
10000011041
10000000011
11100010011
11110000001
10000001041
11000001111
00000011111
L0000011111
11100001111
11100001111
11110000411
11000011111
11110D11111
X
mod-key2
1100U111111
10000201111
10001120011
11000020001
10000011041
10000000011
11100010011
11110000001
10000001041
11000001111
00000011111
L0000011111
11100001111
11100001111
11110000411
11000011111
11110D11111
X
mod-end.
1100U111111
10000201111
10001120011
11000020001
10000011041
10000000011
11100010011
11110000001
10000001041
11000001111
00000011111
L0000011111
11100001111
11100001111
11110000411
11000011111
11110D11111
X