normal
11111111001111111
11111100001111111
1111111U011111111
11111110001111111
11110000000111111
11100001000011111
11000011110000111
11000000111100011
10100001110010011
00100010000100011
00000000110000111
0L011000011100111
11111101111111111
11111100001111111
11111110011111111
11111111111111111
11111111111111111
X
mod-strt
1111100U11
1000000011
1000000011
0000000011
0100010001
0100000111
L000100011
1000000111
1111000111
1111111111
X
mod-key1
1111100U11
1000000011
1000000011
0000000011
0100010001
0100000111
L000100011
1000000111
1111000111
1111111111
X
mod-key2
1111100U11
1000000011
1000000011
0000000011
0100010001
0100000111
L000100011
1000000111
1111000111
1111111111
X
mod-end.
1111100U11
1000000011
1000000011
0000000011
0100010001
0100000111
L000100011
1000000111
1111000111
1111111111
X