normal
1111111...1111111
1111111U.11111111
111000..1...11111
111000....1111111
11.00011...111111
.1111.1001111.111
....100000111..11
..L.00001011.....
1110000000....R..
1111111000...1111
111110000...11111
11110000101111..1
.111000000.111111
.1111110001111111
111110000D11.1111
1111111...1..1111
11111111....11111
X
mod-strt
11111111U1111111
11...111..2.1111
11...2..11..1111
11..11......1111
1..111...222.111
.L.11.....1..111
.111.2....1.....
1111.....1.2..R.
1111........111.
1111..1111.11111
1111...22.11.111
11.1....1..1.111
11.11...1..11111
1111111111D.1111
X
mod-key1
1111111.000111111
11111111U11111111
111100010001.1111
1101011001112.111
1.000010000...111
..111000111......
...1000001112..R.
11L000010111.1111
00000........1111
11111..1111.11111
11111...22.11.111
111.1....1..111.1
111.11...1...11.1
11.11111001.11111
11..11...0...1111
11111111111D.1111
11111111111...111
X
mod-key2
1111111...1111111
1111111U.11111111
111000..1...11111
111000....1111111
11.00011...111111
.1111.1001111.111
....100000111..11
..L.00001011.....
1110000000....R..
1111111000...1111
111110000...11111
11110000101111..1
.111000000.111111
.1111110001111111
111110000D11.1111
1111111...1..1111
11111111....11111
X
mod-end.
11111111U1111111
11111111U1111111
11...111..2.1111
11...2..11..1111
11..11......1111
...111...222.111
LL.11.....1..111
1111.2....1.....
1111.....1.2..RR
1111........1111
1111..1111.11111
1111...22.11.111
11.1....1..1.111
11.11...1..11111
1111111111D.1111
1111111111D.1111
X
_entr
111111111..111111
111111111U1111111
111...111..2.1111
111...2..11..1111
111..11......1111
....111...222.111
..L.11.....1..111
11111.2....1.....
11111..2221.2..R.
11111........1111
11111..1111.11111
11111...22.11.111
111.1....1..111.1
111.11...1...11.1
11111111111D.1111
11111111111...111
1111111111....111
X