normal
1111100U111111111
11110000201111111
11110001120011.11
11111000020001.11
11110000011021111
111100000000111.1
1111110001001...1
1111111000000...1
11110000001021.11
11111000001111.11
000000000111....1
000L00000111..111
1111110000111..11
11111100001....11
11111110000211111
11111000011111111
11111110D11111111
X
mod-strt
1111100U111111111
11110000201111111
11110001120011.11
11111000020001.11
11110000011021111
111100000000111.1
1111110001001...1
1111111000000...1
11110000001021.11
11111000001111.11
000000000111....1
000L00000111..111
1111110000111..11
11111100001....11
11111110000211111
11111000011111111
11111110D11111111
X
mod-key1
1111100U111111111
11110000201111111
11110001120011.11
11111000020001.11
11110000011021111
111100000000111.1
1111110001001...1
1111111000000...1
11110000001021.11
11111000001111.11
000000000111....1
000L00000111..111
1111110000111..11
11111100001....11
11111110000211111
11111000011111111
11111110D11111111
X
mod-key2
1111100U111111111
11110000201111111
11110001120011.11
11111000020001.11
11110000011021111
111100000000111.1
1111110001001...1
1111111000000...1
11110000001021.11
11111000001111.11
000000000111....1
000L00000111..111
1111110000111..11
11111100001....11
11111110000211111
11111000011111111
11111110D11111111
X
mod-end.
1111100U111111111
11110000201111111
11110001120011.11
11111000020001.11
11110000011021111
111100000000111.1
1111110001001...1
1111111000000...1
11110000001021.11
11111000001111.11
000000000111....1
000L00000111..111
1111110000111..11
11111100001....11
11111110000211111
11111000011111111
11111110D11111111
X