normal
11111111001111111
11111100001111111
1111111U011111111
11111110001111111
11110000000111111
11100001000011111
11000011110000111
11100000111100011
10100001110010011
00100010000100011
00000000110000111
0L011000011100111
11111101111111111
11111100001111111
11111110011111111
11111111111111111
11111111111111111
X
mod-strt
11111111001111111
11111100001111111
1111111U011111111
11111110001111111
11110000000111111
11100001000011111
11000011110000111
11000000111100011
10100001110010011
00100010000100011
00000000110000111
0L011000011100111
11111101111111111
11111100001111111
11111110011111111
11111111111111111
11111111111111111
X
mod-key1
11111111001111111
11111100001111111
1111111U011111111
11111110001111111
11110000000111111
11100001000011111
11000011110000111
11000000111100011
10100001110010011
00100010000100011
00000000110000111
0L011000011100111
11111101111111111
11111100001111111
11111110011111111
11111111111111111
11111111111111111
X
mod-key2
11111111001111111
11111100001111111
1111111U011111111
11111110001111111
11110000000111111
11100001000011111
11000011110000111
11000000111100011
10100001110010011
00100010000100011
00000000110000111
0L011000011100111
11111101111111111
11111100001111111
11111110011111111
11111111111111111
11111111111111111
X
mod-end.
11111....111111111
1100100U1111111111
011111001110000011
111..1100111100011
1100010.0110100011
1.0000001110001111
1..0000....0011111
110000.11..1101111
111000..112..00011
0..11.....21100111
.0L0...001.1100111
111.00001110001111
111111.1.0..111111
110111.0.111111111
001111111100011111
011110011111111111
111111111111111111
X