normal
11111100U11111111
11111000010011111
11111000010000111
11111100111100111
11111100001111111
11110000100111111
11100111100011111
11100100110111111
11000000111111111
11110000100111111
111110011111111S1
11111111111111111
11111111111111111
11111111111111111
11111111111111111
11111111111111111
11111111111111111
X
_strt
11111100U11111111
11111000010011111
11111000010000111
11111100111100111
11111100001111111
11110000100111111
11100111100011111
11100100110111111
11000000111100111
11110000100000011
111000000001100S1
10111110000111111
10001111000011111
10000011000011111
11000001133111111
11100000111111111
11111111111111111
X
_key1
11111100U11111111
11111000010011111
11111000010000111
11111100111100111
11111100001111111
11110000100111111
11100111100011111
11100100110111111
11000000111100111
11110000100000011
111000000001100S1
10111110000111111
10001111000011111
10000011000011111
11000001133111111
11100000111111111
11111111111111111
X
_key2
11111100U11111111
11111000010011111
11111000010000111
11111100111100111
11111100001111111
11110000100111111
11100111100011111
11100100110111111
11000000111100111
11110000100000011
111000000001100S1
10111110000111111
10001111000011111
10000011000011111
11000001133111111
11100000111111111
11111111111111111
X
_.end.
11111100U11111111
11111000010011111
11111000010000111
11111100111100111
11111100001111111
11110000100111111
11100111100011111
11100100110111111
11000000111100111
11110000100000011
111000000001100S1
10111110000111111
10001111000011111
10000011000011111
11000001133111111
11100000111111111
11111111111111111
X