normal
111111111111
000000000000
L0000110000R
110000000111
110100001111
111111111111
X
mod-strt
111111111111
000000000000
L0000110000R
110000000111
110100001111
111111111111
X
mod-key1
111111111111
000000000000
L0000110000R
110000000111
110100001111
111111111111
X
mod-key2
111111111111
000000000000
L0000110000R
110000000111
110100001111
111111111111
X
mod-end.
111111111111
000000000000
L0000110000R
110000000111
110100001111
111111111111
X