normal
11111111111
11000001331
11110022001
10000000111
11000000000
L000000000R
11110000011
14010000001
10000001111
10002000011
11002110001
11110200001
111111D0011
X
mod-strt
11111111111
11000001331
11110022001
10000000111
11000000000
L000000000R
11110000011
14010000001
10000001111
10002000011
11002110001
11110200001
111111D0011
X
mod-key1
11111111111
11000001331
11110022001
10000000111
11000000000
L000000000R
11110000011
14010000001
10000001111
10002000011
11002110001
11110200001
111111D0011
X
mod-key2
11111111111
11000001331
11110022001
10000000111
11000000000
L000000000R
11110000011
14010000001
10000001111
10002000011
11002110001
11110200001
111111D0011
X
mod-end.
11111111111
11000001331
11110022001
10000000111
11000000000
L000000000R
11110000011
14010000001
10000001111
10002000011
11002110001
11110200001
111111D0011
X