_hall
1100U111111
10000201111
10001120011
11000020001
10000011041
10000000011
11100010011
11110000001
10000001041
11000001111
00000C00000
L000110000R
11100001111
11100001111
11110000411
11000011111
10000011001
14000110011
11100000001
10022001111
13310000011
11110D11111
X