11000111111
10000201111
10001120011
11000020001
10000011041
10000000011
11100010011
11110000001
10000001041
11000001111
00000C00000
00001100000
11100001111
11100001111
11110000411
11000011111
10000011001
14000110011
11100000001
10022001111
13310000011
11110011111
X
001000111
100000311
111000331
000000021
000000000
020000040
111000111
110002111
110000111
110000111
111001111