normal
1111U11111
0000010001
0001100111
000000000R
1110001111
1100000111
L000010111
0000000111
1111000111
110000D111
X
mod-strt
1111U11111
0000010001
0001100111
000000000R
1110001111
1100000111
L000010111
0000000111
1111000111
110000D111
X
mod-key1
1111U11111
0000010001
0001100111
000000000R
1110001111
1100000111
L000010111
0000000111
1111000111
110000D111
X
mod-key2
1111U11111
0000010001
0001100111
000000000R
1110001111
1100000111
L000010111
0000000111
1111000111
110000D111
X
mod-end.
1111U11111
0000010001
0001100111
000000000R
1110001111
1100000111
L000010111
0000000111
1111000111
110000D111
X
_entr
1111111U11111
1000111002011
1000200110011
1001100000011
0011100022201
L011000001001
1110200001000
111002221020R
1110000000011
1110011110111
1110002201101
1010000100101
1011000100111
111111111D011
X 15y 15x