normal
1111100U11
1000000011
1000000011
0000000011
0100010001
0100000111
L000100011
1000000111
1111000111
1111111111
X
mod-strt
1111100U11
1000000011
1000000011
0000000011
0100010001
0100000111
L000100011
1000000111
1111000111
1111111111
X
mod-key1
1111100U11
1000000011
1000000011
0000000011
0100010001
0100000111
L000100011
1000000111
1111000111
1111111111
X
mod-key2
1111100U11
1000000011
1000000011
0000000011
0100010001
0100000111
L000100011
1000000111
1111000111
1111111111
X
mod-end.
1111100U11
1000000011
1000000011
0000000011
0100010001
0100000111
L000100011
1000000111
1111000111
1111111111
X