normal
1111111111
1110001111
1110000001
1100010000
1110000010
1000100010
110000000R
1100000001
1100000001
1111D01111
X
mod-strt
1111111111
1110001111
1110000001
1100010000
1110000010
1000100010
110000000R
1100000001
1100000001
1111D01111
X
mod-key1
1111111111
1110001111
1110000001
1100010000
1110000010
1000100010
110000000R
1100000001
1100000001
1111D01111
X
mod-key2
1111111111
1110001111
1110000001
1100010000
1110000010
1000100010
110000000R
1100000001
1100000001
1111D01111
X
mod-end.
1111111111
1110001111
1110000001
1100010000
1110000010
1000100010
110000000R
1100000001
1100000001
1111D01111
X