normal
11111111111
11000011111
11000110000
1110110000R
11102100111
11120100011
11020000021
10010000411
11100010111
11220000111
10002001111
10002222111
11001000011
11100011111
11300001111
11111111111
X
_strt
1111111111
1110001111
1110000000
110001000R
1110000011
1S00100011
1100000000
1110000000
110000022R
1111111111
X
_key1
22222222222
22222222222
22222222222
22222222222
22222222222
22222222222
22222222222
22222222222
22222222222
22222222222
X
_key2
22222222222
22222222222
22222222222
22222222222
22222222222
22222222222
22222222222
22222222222
22222222222
22222222222
X
_end.
22222222222
22222222222
22222222222
22222222222
22222222222
22222222222
22222222222
22222222222
22222222222
22222222222
X
