normal
11111U01111
11000001331
11110022001
10000000111
11001100041
11110000111
11111000000
1111100000R
11110000011
111111D0011
X
mod-strt
11111U01111
11000001331
11110022001
10000000111
11001100041
11110000111
11111000000
1111100000R
11110000011
111111D0011
X
mod-key1
11111U01111
11000001331
11110022001
10000000111
11001100041
11110000111
11111000000
1111100000R
11110000011
111111D0011
X
mod-key2
11111U01111
11000001331
11110022001
10000000111
11001100041
11110000111
11111000000
1111100000R
11110000011
111111D0011
X
mod-end.
11111U01111
11000001331
11110022001
10000000111
11001100041
11110000111
11111000000
1111100000R
11110000011
111111D0011
X