normal
111U001111
1110001111
1110000001
110001000R
1110000010
1000100010
1100000000
1100000001
1100000001
1111111111
X
mod-strt
111U001111
1110001111
1110000001
110001000R
1110000010
1000100010
1100000000
1100000001
1100000001
1111111111
X
mod-key1
111U001111
1110001111
1110000001
110001000R
1110000010
1000100010
1100000000
1100000001
1100000001
1111111111
X
mod-key2
111U001111
1110001111
1110000001
110001000R
1110000010
1000100010
1100000000
1100000001
1100000001
1111111111
X
mod-end.
111U001111
1110001111
1110000001
110001000R
1110000010
1000100010
1100000000
1100000001
1100000001
1111111111
X