normal
111U011111
1110001111
1110000001
1100010001
1100000011
1000100011
1110000001
1101001101
1100000001
1110D11111
X
mod-strt
111U011111
1110001111
1110000001
1100010001
1100000011
1000100011
1110000001
1101001101
1100000001
1110D11111
X
mod-key1
111U011111
1110001111
1110000001
1100010001
1100000011
1000100011
1110000001
1101001101
1100000001
1110D11111
X
mod-key2
111U011111
1110001111
1110000001
1100010001
1100000011
1000100011
1110000001
1101001101
1100000001
1110D11111
X
mod-end.
111U011111
1110001111
1110000001
1100010001
1100000011
1000100011
1110000001
1101001101
1100000001
1110D11111
X