normal
1111111111111111111
1111111T000T1111111
1111111TTTTTTT11111
TTTTTTTTT.TTTTTTTTT
R......S..........R
R.....11111.......R
R......111........R
R.................R
R.................R
R.................R
R.................R
R.................R
R.................R
R...x.............R
R.11111...........R
R.1111............R
RRR11RRRRRRRRRRRRRR
X