normal
11111111111111111
11000111110111111
10011111111111111
11111111111111111
11100001100011111
110001000000000S1
11110000100001111
10000000001000111
00001110011000111
0L011100001011111
11001000100011111
10001101111011111
11111111111111111
11111111111111100
11111111110111000
11100111111110000
11111111111111000
X
_strt
1 1 1 1 1 1 1 1 1 1 1 1 1 1 1 1 1
1 1 1 1 1 1 0 1 1 1 1 1 1 1 1 1 1
1 1 1 1 1 1 1 1 1 1 0 1 1 1 1 1 1
1 1 1 1 1 1 1 1 1 1 1 1 1 1 1 1 1
1 1 1 1 1 1 1 1 1 1 1 1 1 1 1 1 1
1 1 1 0 0 0 0 1 1 0 0 0 1 1 1 1 1
1 1 0 0 0 1 0 0 0 0 0 0 0 0 0 S 1
1 1 1 1 0 0 0 0 1 0 0 0 0 1 1 1 1
1 0 0 0 0 0 0 0 0 0 1 0 0 0 1 1 1
0 0 0 0 1 1 1 0 0 1 1 0 0 0 1 1 1
0 L 0 1 1 1 0 0 0 0 1 0 1 1 1 1 1
1 1 0 0 1 0 0 0 1 0 0 0 1 1 1 1 1
1 0 0 0 1 1 0 1 1 1 1 0 1 1 1 1 1
1 1 1 1 1 1 1 1 1 1 1 1 1 1 1 1 1
1 1 1 1 1 1 1 1 1 1 1 1 1 1 1 1 1
1 1 1 1 1 1 1 1 1 1 0 1 1 1 1 1 1
1 1 1 1 1 1 1 1 1 1 1 1 1 1 1 1 1
1 1 1 1 1 1 1 1 1 1 0 1 1 1 1 1 1
1 1 1 1 1 1 0 1 1 1 1 1 1 1 1 1 1
X 19y 17x
_key1
22222222222
22222222222
22222222222
22222222222
22222222222
22222222222
22222222222
22222222222
22222222222
22222222222
X
_key2
22222222222
22222222222
22222222222
22222222222
22222222222
22222222222
22222222222
22222222222
22222222222
22222222222
X
_end.
22222222222
22222222222
22222222222
22222222222
22222222222
22222222222
22222222222
22222222222
22222222222
22222222222
X