normal
11111U01111
11000001331
11110022001
11110000111
11000000000
L000000000R
10002000011
11002110001
11110200001
11111111111
X
mod-strt
11111U01111
11000001331
11110022001
11110000111
11000000000
L000000000R
10002000011
11002110001
11110200001
11111111111
X
mod-key1
11111U01111
11000001331
11110022001
11110000111
11000000000
L000000000R
10002000011
11002110001
11110200001
11111111111
X
mod-key2
11111U01111
11000001331
11110022001
11110000111
11000000000
L000000000R
10002000011
11002110001
11110200001
11111111111
X
mod-end.
11111111U0111111
1111100100001111
1111002210000111
1111000010000111
1100220002110001
0001021010200001
L000011000000000
111000111000000R
1111000000011111
1111111111111111
X