normal
1111U11111
0000010001
0001100111
000000000R
1110001111
1100000111
L000010111
0000000111
1111000111
110000D111
X
mod-strt
1111U11111
0000010001
0001100111
000000000R
1110001111
1100000111
L000010111
0000000111
1111000111
110000D111
X
mod-key1
1111U11111
0000010001
0001100111
000000000R
1110001111
1100000111
L000010111
0000000111
1111000111
110000D111
X
mod-key2
1 1 1 1 1 1 1 U 1 1 1 1 1 1
1 . . . 1 1 1 . . 2 . 1 1 1
1 . . . 2 . . 1 1 . . 1 1 1
1 . . 1 1 . . . . . . 1 1 1
. . 1 1 1 . . . 2 2 2 . 1 1
L . 1 1 . . . . . 1 . . 1 1
1 1 1 . 2 . . . . 1 . . . .
1 1 1 . . . . . 1 . 2 . . R
1 1 1 . . . . . . . . 1 1 1
1 1 1 . . 1 1 1 1 . 1 1 1 1
1 1 1 . . . 2 2 . 1 1 . 1 1
1 . 1 . . . . 1 . . 1 . 1 1
1 . 1 1 . . . 1 . . 1 1 1 1
1 1 1 1 1 1 1 1 1 D . 1 1 1
X
mod-end.
1 1 1 1 1 1 1 U 1 1 1 1 1 1
1 0 0 0 1 1 1 0 0 2 0 1 1 1
1 0 0 0 2 0 0 1 1 0 0 1 1 1
1 0 0 1 1 0 0 0 0 0 0 1 1 1
0 0 1 1 1 0 0 0 2 2 2 0 1 1
L 0 1 1 0 0 0 0 0 1 0 0 1 1
1 1 1 0 2 0 0 0 0 1 0 0 0 0
1 1 1 0 0 0 0 0 1 0 2 0 0 R
1 1 1 0 0 0 0 0 0 0 0 1 1 1
1 1 1 0 0 1 1 1 1 0 1 1 1 1
1 1 1 0 0 0 2 2 0 1 1 0 1 1
1 0 1 0 0 0 0 1 0 0 1 0 1 1
1 0 1 1 0 0 0 1 0 0 1 1 1 1
1 1 1 1 1 1 1 1 1 D 0 1 1 1
X
_entr
111111111..111111
111111111U1111111
111...111..2.1111
111...2..11..1111
111..11......1111
....111...222.111
..L.11.....1..111
11111.2....1.....
11111..2221.2..R.
11111........1111
11111..1111.11111
11111...22.11.111
111.1....1..111.1
111.11...1...11.1
11111111111D.1111
11111111111...111
1111111111....111
X
11111