normal
11111111111111111
11110000111111111
10000011111111111
10000111111111111
11011100011111011
11111100000011111
11111000100001111
11111100000101111
11110001000100000
1111100000000R001
11111000000011111
11111000001111111
11111110011111111
1111111D011111111
11111110001111111
11111100000111111
11111100111111111
X
mod-strt
1111111111
1110001111
1110000001
1100010000
1110000010
1000100010
110000000R
1100000001
1100000001
1111D01111
X
mod-key1
1111111111
1110001111
1110000001
1100010000
1110000010
1000100010
110000000R
1100000001
1100000001
1111D01111
X
mod-key2
1111111111
1110001111
1110000001
1100010000
1110000010
1000100010
110000000R
1100000001
1100000001
1111D01111
X
mod-end.
1111111111
1110001111
1110000001
1100010000
1110000010
1000100010
110000000R
1100000001
1100000001
1111D01111
X