normal
11111110111111111
11111110011111111
1111111U011111111
11111110011111111
11110000013311111
11111100220011111
11100000001111111
11110011000411111
11111100011110111
11111110010000000
1111111000000R001
11111100000111111
11111111000111111
11111111D01111111
11111111001111111
11111111001111111
11111111011111111
X
mod-strt
11111U01111
11000001331
11110022001
10000000111
11001100041
11110000111
11111000000
1111100000R
11110000011
111111D0011
X
mod-key1
11111U01111
11000001331
11110022001
10000000111
11001100041
11110000111
11111000000
1111100000R
11110000011
111111D0011
X
mod-key2
11111U01111
11000001331
11110022001
10000000111
11001100041
11110000111
11111000000
1111100000R
11110000011
111111D0011
X
mod-end.
11111U01111
11000001331
11110022001
10000000111
11001100041
11110000111
11111000000
1111100000R
11110000011
111111D0011
X