normal
11111100000111111
11111000000111111
11110000001111111
111101U0011111111
11111100001111110
11111100000111000
11111000100000000
1111110011010R000
11110001000101100
11111000000001111
11111000000011111
11111000000011111
11111100001111011
11111111111110011
11011111111110111
11001111111111111
11111111111111111
X
mod-strt
111U001111
1110001111
1110000001
110001000R
1110000010
1000100010
1100000000
1100000001
1100000001
1111111111
X
mod-key1
111U001111
1110001111
1110000001
110001000R
1110000010
1000100010
1100000000
1100000001
1100000001
1111111111
X
mod-key2
111U001111
1110001111
1110000001
110001000R
1110000010
1000100010
1100000000
1100000001
1100000001
1111111111
X
mod-end.
111U001111
1110001111
1110000001
110001000R
1110000010
1000100010
1100000000
1100000001
1100000001
1111111111
X