normal
11U00111111
10000001111
11000010111
11110000001
10111100001
10000110011
11000000001
11101000001
10001000111
11101111011
10100010001
10110000011
11100000011
11000000111
111110D1111
X
mod-strt
111U011111
1110001111
1110000001
1100010001
1100000011
1000100011
1110000001
1101001101
1100000001
1110D11111
X
mod-key1
111U011111
1110001111
1110000001
1100010001
1100000011
1000100011
1110000001
1101001101
1100000001
1110D11111
X
mod-key2
111U011111
1110001111
1110000001
1100010001
1100000011
1000100011
1110000001
1101001101
1100000001
1110D11111
X
mod-end.
111U011111
1110001111
1110000001
1100010001
1100000011
1000100011
1110000001
1101001101
1100000001
1110D11111
X